Grapheme	IPA	Note
^precisar$	p ɾ e s i z a ʁ
^entrar$	ẽ t ɾ a ʁ
^jogar$	ʒ o ɡ a ʁ
^faca$	f a k ɐ
^suportar$	s u p o ʁ t a ʁ
^casca$	k a ʃ k ɐ
^achar$	a ʃ a ʁ
^prisioneiro$	p ɾ i z j o n ei ɾ u
^conservar$	k õ s e ʁ v a ʁ
^salobre$	s a l ɔ b ɾ i
^trapo$	t ɾ a p u
^demorar$	d e m o ɾ a ʁ
^rombudo$	ʁ õ b u d u
^atirar$	a tʃ i ɾ a ʁ
^extinguir$	i ʃ tʃ ĩ ɡ i ʁ
^madrasta$	m a d ɾ a ʃ t ɐ
^dar_ordem$	d a ʁ + ɔ ʁ d ẽĩ
^cozer_no_forno$	k o z e ʁ + n u + f ɔ ʁ n u
^carneiro$	k a ʁ n ei ɾ u
^envolver$	ẽ v ɔu v e ʁ
^enrolar$	ẽ ʁ o l a ʁ
^cru$	k ɾ u
^folha$	f ɔ ʎ ɐ
^esperto$	i ʃ p ɛ ʁ t u
^casa_de_homens$	k a z ɐ + dʒ i + ɔ m ẽ ʃ
^pasto$	p a ʃ t u
^fogão$	f o ɡ ɐ̃ũ
^enxó$	ẽ ʃ ɔ
^vir$	v i ʁ
^acabar$	a k a b a ʁ
^leão$	l j ɐ̃ũ
^funda$	f ũ d ɐ
^leal$	l i au
^enguia$	ẽ ɡ i ɐ
^novo$	n ɔ v u
^véu$	v ɛu
^quarta-feira$	k w a ʁ t a f ei ɾ ɐ
^jacaré$	ʒ a k a ɾ ɛ
^grávida$	ɡ ɾ a v i d ɐ
^absolver$	a b s ɔu v e ʁ
^crescer$	k ɾ e ʃ s e ʁ
^ter_relações_sexuais$	t e ʁ + ʁ e l a s õĩ ʃ + s e k s u ai ʃ
^estar_em_pé$	i ʃ t a ʁ + ẽĩ + p ɛ
^carpete$	k a ʁ p ɛ tʃ i
^você$	v o s e
^chapinhar$	ʃ a p i ɲ a ʁ
^ferramenta$	f e ʁ ɐ m ẽ t ɐ
^espírito$	i ʃ p i ɾ i t u
^bengala$	b ẽ ɡ a l ɐ
^feitiçaria$	f ei tʃ i s a ɾ i ɐ
^esmagar$	i ʒ m a ɡ a ʁ
^doce$	d ɔ s i
^fedorento$	f e d o ɾ ẽ t u
^prenhe$	p ɾ e ɲ i
^forquilha$	f o ʁ k i ʎ ɐ
^misturar$	m i ʃ t u ɾ a ʁ
^comprido$	k õ p ɾ i d u
^babar$	b a b a ʁ
^redondo$	ʁ e d õ d u
^sonhar$	s o ɲ a ʁ
^axila$	a k s i l ɐ
^voltar$	v ɔu t a ʁ
^matar$	m a t a ʁ
^noz$	n ɔ ʃ
^velha$	v ɛ ʎ ɐ
^remar$	ʁ e m a ʁ
^mais$	m ai ʃ
^jóia$	ʒ ɔi ɐ
^martelo$	m a ʁ t ɛ l u
^dedo_do_pé$	d ɛ d u + d u + p ɛ
^captar$	k a p t a ʁ
^agouro$	a ɡ o ɾ u
^gosto$	ɡ ɔ ʃ t u
^rim$	ʁ ĩ
^nevoeiro$	n e v o ei ɾ u
^golfinho$	ɡ ɔu f i ɲ u
^gafanhoto$	ɡ a f ɐ ɲ ɔ t u
^morder$	m o ʁ d e ʁ
^queimar$	k ei m a ʁ
^cabaça$	k a b a s ɐ
^fraco$	f ɾ a k u
^aranha$	a ɾ ɐ ɲ ɐ
^unha$	u ɲ ɐ
^tentar$	t ẽ t a ʁ
^verdadeiro$	v e ʁ d a d ei ɾ u
^alguns$	au ɡ ũ ʃ
^dar_a_volta$	d a ʁ + a + v ɔu t ɐ
^difícil$	dʒ i f i s iu
^coxo$	k ɔ ʃ u
^golpear$	ɡ ɔu p i a ʁ
^negativo$	n e ɡ a tʃ i v u
^tremer$	t ɾ e m e ʁ
^errar$	i ʁ a ʁ
^tolo$	t ɔ l u
^sapé$	s a p ɛ
^bruxo$	b ɾ u ʃ u
^garça$	ɡ a ʁ s ɐ
^baixar$	b ai ʃ a ʁ
^guizo$	ɡ i z u
^corvo$	k ɔ ʁ v u
^avó$	a v ɔ
^liso$	l i z u
^bom$	b õ
^casa_de_reunião$	k a z ɐ + dʒ i + ʁ eu n i ɐ̃ũ
^voz$	v ɔ ʃ
^rio$	ʁ j ɔ
^remoinho$	ʁ e m oi ɲ u
^barulho$	b a ɾ u ʎ u
^explicar$	i ʃ p l i k a ʁ
^ponta$	p õ t ɐ
^clã$	k l ɐ̃
^conceber$	k õ s e b e ʁ
^teta$	t ɛ t ɐ
^respirar$	ʁ e ʃ p i ɾ a ʁ
^escama$	i ʃ k ɐ m ɐ
^povo$	p ɔ v u
^colmeia$	k ɔu m ei ɐ
^argila$	a ʁ ʒ i l ɐ
^rei$	ʁ ei
^plantar$	p l ɐ̃ t a ʁ
^massa$	m a s ɐ
^nó$	n ɔ
^vestir$	v e ʃ tʃ i ʁ
^polegar$	p o l e ɡ a ʁ
^fitar$	f i t a ʁ
^culpa$	k uu p ɐ
^comer$	k o m e ʁ
^suspeitar$	s u ʃ p ei t a ʁ
^amargo$	ɐ m a ʁ ɡ u
^sempre$	s ẽ p ɾ i
^primavera$	p ɾ i m a v e ɾ ɐ
^sangue$	s ɐ̃ ɡ i
^barriga_da_perna$	b a ʁ i ɡ ɐ + d ɐ + p ɛ ʁ n ɐ
^neto$	n ɛ t u
^espada$	i ʃ p a d ɐ
^morto$	m ɔ ʁ t u
^pedir_emprestado$	p e dʒ i ʁ + ẽ p ɾ e ʃ t a d u
^odiar$	o dʒ i a ʁ
^urubu$	u ɾ u b u
^cadeado$	k a dʒ i a d u
^irmão_mais_novo$	i ʁ m ɐ̃ũ + m ai ʒ + n ɔ v u
^ponte$	p õ tʃ i
^julgamento$	ʒ uu ɡ ɐ m ẽ t u
^esburacar$	i ʒ b u ɾ a k a ʁ
^linguiça$	l ĩ ɡ i s ɐ
^omoplata$	o m o p l a t ɐ
^negro$	n ɛ ɡ ɾ u
^mamilo$	m ɐ m i l u
^casada$	k a z a d ɐ
^perigo$	p e ɾ i ɡ u
^fundir$	f ũ dʒ i ʁ
^capacete$	k a p a s ɛ tʃ i
^jejuar$	ʒ e ʒ u a ʁ
^contente$	k õ t ẽ tʃ i
^maduro$	m a d u ɾ u
^acusar$	a k u z a ʁ
^abeto$	a b ɛ t u
^colmo$	k ɔu m u
^cadeia$	k a d ei ɐ
^âncora$	ɐ̃ k u ɾ ɐ
^anel$	ɐ n ɛu
^calmaria$	k au m a ɾ i ɐ
^calhau$	k a ʎ au
^igreja$	i ɡ ɾ e ʒ ɐ
^em_cima$	ẽĩ + s i m ɐ
^erro$	ɛ ʁ u
^castigo$	k a ʃ tʃ i ɡ u
^inchação$	ĩ ʃ a s ɐ̃ũ
^amanhecer$	ɐ m ɐ ɲ e s e ʁ
^sarar$	s a ɾ a ʁ
^colar$	k o l a ʁ
^forasteiro$	f o ɾ a ʃ t ei ɾ u
^cana_de_açúcar$	k ɐ n ɐ + dʒ i + a s u k a ʁ
^quatro$	k w a t ɾ u
^relâmpago$	ʁ e l ɐ̃ p a ɡ u
^cidadão$	s i d a d ɐ̃ũ
^bolha$	b ɔ ʎ ɐ
^açúcar$	a s u k a ʁ
^bolso$	b ɔu s u
^esquerda$	i s k ɛ ʁ d ɐ
^levar$	l e v a ʁ
^lenha$	l e ɲ ɐ
^duas_vezes$	d u a ʃ + v ɛ z e ʃ
^coador$	k o a d o ʁ
^queixoso$	k ei ʃ ɔ z u
^desembarcar$	d e z ẽ b a ʁ k a ʁ
^obedecer$	o b e d e s e ʁ
^ansiedade$	ɐ̃ s i e d a dʒ i
^nassa$	n a s ɐ
^braça$	b ɾ a s ɐ
^má_sorte$	m a + s ɔ ʁ tʃ i
^ver$	v e ʁ
^se$	s i
^elmo$	ɛu m u
^verme$	v ɛ ʁ m i
^lagarto$	l a ɡ a ʁ t u
^duro$	d u ɾ u
^atrasar$	a t ɾ a z a ʁ
^dar$	d a ʁ
^peça$	p ɛ s ɐ
^arraia$	a ʁ ai ɐ
^caveira$	k a v ei ɾ ɐ
^destruir$	d e ʃ t ɾ ui ʁ
^anzol$	ɐ̃ z ɔu
^gaivota$	ɡ ai v ɔ t ɐ
^fechadura$	f e ʃ a d u ɾ ɐ
^cintura$	s ĩ t u ɾ ɐ
^serra$	s ɛ ʁ ɐ
^raiz$	ʁ ai ʃ
^provar$	p ɾ o v a ʁ
^gadanha$	ɡ a d ɐ ɲ ɐ
^ídolo$	i d u l u
^útero$	u t e ɾ u
^morteiro$	m o ʁ t ei ɾ u
^calças$	k au s a ʃ
^seguro$	s e ɡ u ɾ u
^não$	n ɐ̃ũ
^ressonar$	ʁ e s o n a ʁ
^jardim$	ʒ a ʁ dʒ ĩ
^apanhar$	a p ɐ ɲ a ʁ
^almofariz$	au m o f a ɾ i ʃ
^escada$	i ʃ k a d ɐ
^lavar$	l a v a ʁ
^cabrito$	k a b ɾ i t u
^correto$	k o ʁ ɛ t u
^olhar_para$	o ʎ a ʁ + p a ɾ ɐ
^cozinhar$	k o z i ɲ a ʁ
^morro$	m ɔ ʁ u
^nada$	n a d ɐ
^horta$	ɔ ʁ t ɐ
^fio$	f j ɔ
^morar$	m o ɾ a ʁ
^pronto$	p ɾ õ t u
^e$	i
^cola$	k ɔ l ɐ
^verão$	v e ɾ ɐ̃ũ
^frigir$	f ɾ i ʒ i ʁ
^abelha$	a b e ʎ ɐ
^azul$	a z uu
^pálpebra$	p au p e b ɾ ɐ
^órfão$	ɔ ʁ f ɐ̃ũ
^tempo$	t ẽ p u
^pulmão$	p uu m ɐ̃ũ
^pato$	p a t u
^urso$	u ʁ s u
^ao_lado_de$	a u + l a d u + dʒ i
^disparar$	dʒ i ʃ p a ɾ a ʁ
^carruagem$	k a ʁ u a ʒ ẽĩ
^nobre$	n ɔ b ɾ i
^marido$	m a ɾ i d u
^coelho$	k o e ʎ u
^chamar$	ʃ ɐ m a ʁ
^levar_na_mão$	l e v a ʁ + n a + m ɐ̃ũ
^enteada$	ẽ tʃ i a d ɐ
^feltro$	f ɛu t ɾ u
^sacerdote$	s a s e ʁ d ɔ tʃ i
^quintal$	k ĩ t au
^fortaleza$	f o ʁ t a l ɛ z ɐ
^dizer$	dʒ i z e ʁ
^quanto$	k w ɐ̃ t u
^animal$	ɐ n i m au
^chuva$	ʃ u v ɐ
^condenar$	k õ d e n a ʁ
^nuvem$	n u v ẽĩ
^cascata$	k a ʃ k a t ɐ
^bambu$	b ɐ̃ b u
^demônio$	d e m o n j u
^mente$	m ẽ tʃ i
^mudo$	m u d u
^largo$	l a ʁ ɡ u
^gema$	ʒ ɛ m ɐ
^centro$	s ẽ t ɾ u
^pátio$	p a t j u
^centopeia$	s ẽ t o p ei ɐ
^outra_vez$	o t ɾ ɐ + v e ʃ
^vitória$	v i t ɔ ɾ i ɐ
^intestinos$	ĩ t e ʃ tʃ i n u ʃ
^flecha$	f l e ʃ ɐ
^porta$	p ɔ ʁ t ɐ
^exército$	i z ɛ ʁ s i t u
^queixo$	k ei ʃ u
^umbral$	ũ b ɾ au
^hóspede$	ɔ ʃ p e dʒ i
^cevada$	s e v a d ɐ
^roubar$	ʁ o b a ʁ
^telhado$	t e ʎ a d u
^luva$	l u v ɐ
^roncar$	ʁ õ k a ʁ
^disputa$	dʒ i ʃ p u t ɐ
^palmo$	p au m u
^intenção$	ĩ t ẽ s ɐ̃ũ
^antepassados$	ɐ̃ t e p a s a d u ʃ
^miçanga$	m i s ɐ̃ ɡ ɐ
^linha_de_pesca$	l i ɲ ɐ + dʒ i + p ɛ ʃ k ɐ
^enxada$	ẽ ʃ a d ɐ
^espuma$	i ʃ p u m ɐ
^brasas$	b ɾ a z a ʃ
^pus$	p u ʃ
^professor$	p ɾ o f e s ɔ ʁ
^tábua$	t a b u ɐ
^irmã_mais_velha$	i ʁ m ɐ̃ + m ai ʃ + v ɛ ʎ ɐ
^atrás$	a t ɾ a ʃ
^caldo$	k au d u
^colecionar$	k o l e s j o n a ʁ
^bonito$	b o n i t u
^este$	ɛ ʃ tʃ i
^molar$	m o l a ʁ
^cultivar$	k uu tʃ i v a ʁ
^cessar$	s e s a ʁ
^eu$	eu
^trepar$	t ɾ e p a ʁ
^inseto$	ĩ s ɛ t u
^pomba$	p õ b ɐ
^altar$	au t a ʁ
^mascar$	m a ʃ k a ʁ
^seiva$	s ei v ɐ
^galho$	ɡ a ʎ u
^cama$	k ɐ m ɐ
^arma$	a ʁ m ɐ
^segurar$	s e ɡ u ɾ a ʁ
^armas$	a ʁ m a ʃ
^mula$	m u l ɐ
^flor$	f l ɔ ʁ
^pulseira$	p uu s ei ɾ ɐ
^tronco$	t ɾ õ k u
^norte$	n ɔ ʁ tʃ i
^ombro$	õ b ɾ u
^porca$	p ɔ ʁ k ɐ
^feliz$	f e l i ʃ
^leite$	l ei tʃ i
^por_muito_tempo$	p u ʁ + m ũ j t u + t ẽ p u
^esculpir$	i ʃ k uu p i ʁ
^esposa$	i ʃ p ɔ z ɐ
^nome$	n ɔ m i
^torcer$	t o ʁ s e ʁ
^lado$	l a d u
^moldar$	m ɔu d a ʁ
^rama_bifurcada$	ʁ ɐ m ɐ + b i f u ʁ k a d ɐ
^parentes$	p a ɾ ẽ t e ʃ
^penhasco$	p e ɲ a ʃ k u
^só$	s ɔ
^rede$	ʁ ɛ dʒ i
^elas$	ɛ l a ʃ
^crânio$	k ɾ ɐ n j u
^raio$	ʁ ai u
^gamela$	ɡ ɐ m ɛ l ɐ
^alto$	au t u
^pinça$	p ĩ s ɐ
^baniana$	b ɐ n i ɐ n ɐ
^fruta$	f ɾ u t ɐ
^saúde$	s a u dʒ i
^mandar$	m ɐ̃ d a ʁ
^cacete$	k a s ɛ tʃ i
^espirrar$	i ʃ p i ʁ a ʁ
^galinha$	ɡ a l i ɲ ɐ
^fugir$	f u ʒ i ʁ
^pesar$	p e z a ʁ
^duvidar$	d u v i d a ʁ
^tapete$	t a p ɛ tʃ i
^agarrar$	a ɡ a ʁ a ʁ
^bronze$	b ɾ õ z i
^virar$	v i ɾ a ʁ
^mandioca$	m ɐ̃ d j ɔ k ɐ
^linho$	l i ɲ u
^descansar$	d e ʃ k ɐ̃ s a ʁ
^agachar-se$	a ɡ a ʃ a ʁ s i
^fome$	f ɔ m i
^pântano$	p ɐ̃ t ɐ n u
^moer$	m o e ʁ
^matraca$	m a t ɾ a k ɐ
^julgar$	ʒ uu ɡ a ʁ
^cinto$	s ĩ t u
^estragar$	i ʃ t ɾ a ɡ a ʁ
^couro$	k o ɾ u
^ajudar$	a ʒ u d a ʁ
^muco$	m u k u
^teto$	t ɛ t u
^copo$	k ɔ p u
^afundar$	a f ũ d a ʁ
^sabor$	s a b ɔ ʁ
^rã$	ʁ ɐ̃
^mão$	m ɐ̃ũ
^jangada$	ʒ ɐ̃ ɡ a d ɐ
^onze$	õ z i
^guardar$	ɡ w a ʁ d a ʁ
^fêmea$	f e m i ɐ
^bebida$	b e b i d ɐ
^quebrar$	k e b ɾ a ʁ
^prato$	p ɾ a t u
^levantar$	l e v ɐ̃ t a ʁ
^alfinete$	au f i n ɛ tʃ i
^três$	t ɾ e ʃ
^devagar$	d e v a ɡ a ʁ
^criado$	k ɾ i a d u
^escolher$	i ʃ k o ʎ e ʁ
^imposto$	ĩ p o ʃ t u
^cacho$	k a ʃ u
^esfolar$	i ʃ f o l a ʁ
^mastro$	m a ʃ t ɾ u
^estar_com_fome$	i ʃ t a ʁ + k õ + f ɔ m i
^estábulo$	i ʃ t a b u l u
^figo$	f i ɡ u
^ira$	i ɾ ɐ
^manteiga$	m ɐ̃ t ei ɡ ɐ
^distribuir$	dʒ i ʃ t ɾ i b ui ʁ
^fumaça$	f u m a s ɐ
^espelho$	i ʃ p e ʎ u
^brinco$	b ɾ ĩ k u
^arrastar-se$	a ʁ a ʃ t a ʁ s i
^mentir$	m ẽ tʃ i ʁ
^guinchar$	ɡ ĩ ʃ a ʁ
^rabo$	ʁ a b u
^linha$	l i ɲ ɐ
^poeta$	p o ɛ t ɐ
^fonte$	f õ tʃ i
^cheiroso$	ʃ ei ɾ ɔ z u
^bola$	b o l ɐ
^hora$	ɔ ɾ ɐ
^cântaro$	k ɐ̃ t a ɾ u
^barriga$	b a ʁ i ɡ ɐ
^portão$	p o ʁ t ɐ̃ũ
^trair$	t ɾ a i ʁ
^lágrima$	l a ɡ ɾ i m ɐ
^gerar$	ʒ e ɾ a ʁ
^comprimir$	k õ p ɾ i m i ʁ
^cerca$	s ɛ ʁ k ɐ
^elefante$	i l e f ɐ̃ tʃ i
^amassar$	ɐ m a s a ʁ
^coco$	k ɔ k u
^boca$	b ɔ k ɐ
^fumar$	f u m a ʁ
^murmurar$	m u ʁ m u ɾ a ʁ
^mar$	m a ʁ
^pedaço$	p e d a s u
^torcido$	t o ʁ s i d u
^assar$	a s a ʁ
^plano$	p l ɐ n u
^beira$	b ei ɾ ɐ
^cantar$	k ɐ̃ t a ʁ
^prego$	p ɾ ɛ ɡ u
^rosto$	ʁ ɔ ʃ t u
^arremessar$	a ʁ e m e s a ʁ
^trabalhar$	t ɾ a b a ʎ a ʁ
^cor$	k ɔ ʁ
^acordar$	a k o ʁ d a ʁ
^fácil$	f a s iu
^batata_doce$	b a t a t ɐ + d ɔ s i
^agitar$	a ʒ i t a ʁ
^ficar_em_pé$	f i k a ʁ + ẽĩ + p ɛ
^Deus$	d eu ʃ
^claro$	k l a ɾ u
^prisão$	p ɾ i z ɐ̃ũ
^anca$	ɐ̃ k ɐ
^casar$	k a z a ʁ
^ombreira$	õ b ɾ ei ɾ ɐ
^calcanhar$	k au k ɐ ɲ a ʁ
^gêmeos$	ʒ e m i u ʃ
^mosquito$	m o s k i t u
^fita_para_cabeça$	f i t ɐ + p a ɾ ɐ + k a b ɛ s ɐ
^engano$	ẽ ɡ ɐ n u
^bracelete$	b ɾ a s e l ɛ tʃ i
^mês$	m e ʃ
^vestido$	v e ʃ tʃ i d u
^sete$	s ɛ tʃ i
^par$	p a ʁ
^mulso$	m uu s u
^homem$	ɔ m ẽĩ
^cobre$	k ɔ b ɾ i
^vaga-lume$	v a ɡ a l u m i
^tristeza$	t ɾ i ʃ t ɛ z ɐ
^perseguir$	p e ʁ s e ɡ i ʁ
^religião$	ʁ e l i ʒ i ɐ̃ũ
^flauta$	f l au t ɐ
^extremidade$	i ʃ t ɾ e m i d a dʒ i
^ventilar$	v ẽ tʃ i l a ʁ
^pão$	p ɐ̃ũ
^são$	s ɐ̃ũ
^escultor$	i ʃ k uu t o ʁ
^gotejar$	ɡ o t e ʒ a ʁ
^baço$	b a s u
^luz$	l u ʃ
^ter_pena$	t e ʁ + p ɛ n ɐ
^defender$	d e f ẽ d e ʁ
^barrão$	b a ʁ ɐ̃ũ
^cego$	s ɛ ɡ u
^coceira$	k o s ei ɾ ɐ
^cilada$	s i l a d ɐ
^fada$	f a d ɐ
^meia$	m ei ɐ
^menino$	m e n i n u
^trazer$	t ɾ a z e ʁ
^multidão$	m uu tʃ i d ɐ̃ũ
^forja$	f ɔ ʁ ʒ ɐ
^barato$	b a ɾ a t u
^manhã$	m ɐ ɲ ɐ̃
^ferimento$	f e ɾ i m ẽ t u
^macho$	m a ʃ u
^avô$	a v o
^primo$	p ɾ i m u
^pastagem$	p a ʃ t a ʒ ẽĩ
^ferir$	f e ɾ i ʁ
^navegar$	n a v e ɡ a ʁ
^hospedeiro$	o ʃ p e d ei ɾ u
^chave$	ʃ a v i
^adultério$	a d uu t ɛ ɾ j u
^sábado$	s a b a d u
^empurrar$	ẽ p u ʁ a ʁ
^abençoar$	a b ẽ s o a ʁ
^almoço$	au m ɔ s u
^sacrifício$	s a k ɾ i f i s j u
^capitular$	k a p i t u l a ʁ
^perfurar$	p e ʁ f u ɾ a ʁ
^sair$	s a i ʁ
^coar$	k o a ʁ
^corajoso$	k o ɾ a ʒ ɔ z u
^seio$	s ei u
^poncho$	p õ ʃ u
^camundongo$	k ɐ m ũ d õ ɡ u
^ungüento$	ũ ɡ ẽ t u
^pestana$	p e ʃ t ɐ n ɐ
^inimigo$	i n i m i ɡ u
^quente$	k ẽ tʃ i
^lançar$	l ɐ̃ s a ʁ
^tu$	t u
^lança$	l ɐ̃ s ɐ
^trigo$	t ɾ i ɡ u
^eles$	ɛ l e ʃ
^descer$	d e ʃ s e ʁ
^emprestar$	ẽ p ɾ e ʃ t a ʁ
^canal$	k ɐ n au
^tribunal$	t ɾ i b u n au
^vomitar$	v o m i t a ʁ
^promontório$	p ɾ o m õ t ɔ ɾ j u
^forte$	f ɔ ʁ tʃ i
^sôbre$	s o b ɾ i
^adorar$	a d o ɾ a ʁ
^espremer$	i ʃ p ɾ e m e ʁ
^cedo$	s ɛ d u
^batalha$	b a t a ʎ ɐ
^veia$	v ei ɐ
^coxa$	k ɔ ʃ ɐ
^estação$	i ʃ t a s ɐ̃ũ
^porrete$	p o ʁ ɛ tʃ i
^boi$	b oi
^azeite$	a z ei tʃ i
^defecar$	d e f e k a ʁ
^moça$	m ɔ s ɐ
^ovelha$	o v e ʎ ɐ
^imaturo$	i m a t u ɾ u
^fim$	f ĩ
^mosca$	m ɔ ʃ k ɐ
^restituir$	ʁ e ʃ tʃ i t ui ʁ
^piolho$	p j ɔ ʎ u
^rato$	ʁ a t u
^estanho$	i ʃ t ɐ ɲ u
^nádegas$	n a d e ɡ a ʃ
^toco$	t ɔ k u
^mole$	m ɔ l i
^avarento$	a v a ɾ ẽ t u
^abrir$	a b ɾ i ʁ
^encontrar$	ẽ k õ t ɾ a ʁ
^pá$	p a
^somente$	s o m ẽ tʃ i
^cozido$	k o z i d u
^corneta$	k o ʁ n ɛ t ɐ
^buraco$	b u ɾ a k u
^vinte$	v ĩ tʃ i
^quebrado$	k e b ɾ a d u
^pilhagem$	p i ʎ a ʒ ẽĩ
^prima$	p ɾ i m ɐ
^gado$	ɡ a d u
^pequeno-almoço$	p e k e n o au m ɔ s u
^bota$	b ɔ t ɐ
^ombreira_da_porta$	õ b ɾ ei ɾ ɐ + d ɐ + p ɔ ʁ t ɐ
^adivinhar$	a dʒ i v i ɲ a ʁ
^amarelo$	ɐ m a ɾ ɛ l u
^alimento$	a l i m ẽ t u
^forno$	f ɔ ʁ n u
^arder$	a ʁ d e ʁ
^engolir$	ẽ ɡ o l i ʁ
^gengiva$	ʒ ẽ ʒ i v ɐ
^conta$	k õ t ɐ
^areia$	a ɾ ei ɐ
^anfitrião$	ɐ̃ f i t ɾ i ɐ̃ũ
^vós$	v ɔ ʃ
^terra_firme$	t ɛ ʁ ɐ + f i ʁ m i
^templo$	t ẽ p l u
^jovem$	ʒ ɔ v ẽĩ
^cheirar$	ʃ ei ɾ a ʁ
^ferver$	f e ʁ v e ʁ
^amar$	ɐ m a ʁ
^panela$	p ɐ n ɛ l ɐ
^mergulhar$	m e ʁ ɡ u ʎ a ʁ
^empilhar$	ẽ p i ʎ a ʁ
^estafado$	i ʃ t a f a d u
^morcego$	m o ʁ s ɛ ɡ u
^susto$	s u ʃ t u
^uva$	u v ɐ
^maré$	m a ɾ ɛ
^terremoto$	t e ʁ e m ɔ t u
^cérebro$	s ɛ ɾ e b ɾ u
^dentro$	d ẽ t ɾ u
^beber$	b e b e ʁ
^transpirar$	t ɾ ɐ̃ ʃ p i ɾ a ʁ
^bote$	b ɔ tʃ i
^segunda-feira$	s e ɡ ũ d a f ei ɾ ɐ
^puxar$	p u ʃ a ʁ
^estômago$	i ʃ t o m a ɡ u
^estranho$	i ʃ t ɾ ɐ ɲ u
^sarigüê$	s a ɾ i ɡ e
^tesoura$	t e z o ɾ ɐ
^unir$	u n i ʁ
^respiração$	ʁ e ʃ p i ɾ a s ɐ̃ũ
^parede$	p a ɾ ɛ dʒ i
^filho$	f i ʎ u
^fino$	f i n u
^viúva$	v i u v ɐ
^certo$	s ɛ ʁ t u
^abater$	a b a t e ʁ
^farejar$	f a ɾ e ʒ a ʁ
^pastor$	p a ʃ t o ʁ
^lêndea$	l ẽ dʒ i ɐ
^derrubar$	d e ʁ u b a ʁ
^andar$	ɐ̃ d a ʁ
^dirigir$	dʒ i ɾ i ʒ i ʁ
^lombriga$	l õ b ɾ i ɡ ɐ
^saia$	s ai ɐ
^macio$	m a s j u
^cozinha$	k o z i ɲ ɐ
^ruído$	ʁ u i d u
^perto$	p ɛ ʁ t u
^tenda$	t ẽ d ɐ
^ameaçar$	ɐ m i a s a ʁ
^sovela$	s o v ɛ l ɐ
^bacia$	b a s i ɐ
^tabaco$	t a b a k u
^governar$	ɡ o v e ʁ n a ʁ
^fazer$	f a z e ʁ
^ventre$	v ẽ t ɾ i
^agora$	a ɡ ɔ ɾ ɐ
^testículo$	t e ʃ tʃ i k u l u
^dez$	d ɛ ʃ
^primeiro$	p ɾ i m ei ɾ u
^touro$	t o ɾ u
^trinco$	t ɾ ĩ k u
^onda$	õ d ɐ
^espantado$	i ʃ p ɐ̃ t a d u
^gorro$	ɡ ɔ ʁ u
^reunir$	ʁ eu n i ʁ
^cachorro$	k a ʃ ɔ ʁ u
^ler$	l e ʁ
^pouco$	p o k u
^soltar$	s ɔu t a ʁ
^necessidade$	n e s e s i d a dʒ i
^imitar$	i m i t a ʁ
^testa$	t ɛ ʃ t ɐ
^pele$	p ɛ l i
^escorregar$	i ʃ k o ʁ e ɡ a ʁ
^esquecer-se$	i s k e s ɛ ʁ s i
^dar_um_pontapé$	d a ʁ + ũ + p õ t a p ɛ
^inferno$	ĩ f ɛ ʁ n u
^dever$	d e v e ʁ
^azar$	a z a ʁ
^jamais$	ʒ ɐ m ai ʃ
^nadar$	n a d a ʁ
^fragante$	f ɾ a ɡ ɐ̃ tʃ i
^garganta$	ɡ a ʁ ɡ ɐ̃ t ɐ
^seco$	s e k u
^cerveja$	s e ʁ v e ʒ ɐ
^uma$	u m ɐ
^negar$	n e ɡ a ʁ
^oceano$	o s i ɐ n u
^casa_de_jardim$	k a z ɐ + dʒ i + ʒ a ʁ dʒ ĩ
^bocejar$	b o s e ʒ a ʁ
^abanar$	a b ɐ n a ʁ
^levar_na_cabeça$	l e v a ʁ + n a + k a b ɛ s ɐ
^viver$	v i v e ʁ
^falta$	f au t ɐ
^inhame$	i ɲ ɐ m i
^delfim$	d ɛu f ĩ
^afirmativo$	a f i ʁ m a tʃ i v u
^cogumelo$	k o ɡ u m ɛ l u
^irmã_mais_nova$	i ʁ m ɐ̃ + m ai ʒ + n ɔ v ɐ
^chama$	ʃ ɐ m ɐ
^inverno$	ĩ v ɛ ʁ n u
^carvalho$	k a ʁ v a ʎ u
^mover$	m o v e ʁ
^conseguir$	k õ s e ɡ i ʁ
^fantasma$	f ɐ̃ t a ʒ m ɐ
^gato$	ɡ a t u
^juntar$	ʒ ũ t a ʁ
^nove$	n ɔ v i
^malagueta$	m a l a ɡ ɛ t ɐ
^escrever$	i ʃ k ɾ e v e ʁ
^terça-feira$	t e ʁ s a f ei ɾ ɐ
^direito$	dʒ i ɾ ei t u
^mercado$	m e ʁ k a d u
^tomar$	t o m a ʁ
^garra$	ɡ a ʁ ɐ
^cochichar$	k o ʃ i ʃ a ʁ
^feno$	f ɛ n u
^seis$	s ei ʃ
^ano$	ɐ n u
^peito$	p ei t u
^refeição$	ʁ e f ei s ɐ̃ũ
^danificar$	d ɐ n i f i k a ʁ
^surpreso$	s u ʁ p ɾ ɛ z u
^perguntar$	p e ʁ ɡ ũ t a ʁ
^borda$	b ɔ ʁ d ɐ
^bananeira$	b ɐ n ɐ n ei ɾ ɐ
^molhado$	m o ʎ a d u
^residir$	ʁ e z i dʒ i ʁ
^foice$	f oi s i
^ferreiro$	f e ʁ ei ɾ u
^debulhar$	d e b u ʎ a ʁ
^candeeiro$	k ɐ̃ d e ei ɾ u
^canto$	k ɐ̃ t u
^velho$	v ɛ ʎ u
^tarde$	t a ʁ dʒ i
^borboleta$	b o ʁ b o l ɛ t ɐ
^alvorada$	au v o ɾ a d ɐ
^moeda$	m o ɛ d ɐ
^inveja$	ĩ v e ʒ ɐ
^criança$	k ɾ i ɐ̃ s ɐ
^pulga$	p uu ɡ ɐ
^fundo$	f ũ d u
^guarda$	ɡ w a ʁ d ɐ
^agudo$	a ɡ u d u
^cidade$	s i d a dʒ i
^carvão$	k a ʁ v ɐ̃ũ
^crer$	k ɾ e ʁ
^ávido$	a v i d u
^vivo$	v i v u
^desaparecer$	d e z a p a ɾ e s e ʁ
^almofada$	au m o f a d ɐ
^preto$	p ɾ ɛ t u
^filhos$	f i ʎ u ʃ
^armar_uma_cilada$	a ʁ m a ʁ + u m ɐ + s i l a d ɐ
^artéria$	a ʁ t ɛ ɾ i ɐ
^vento$	v ẽ t u
^rir$	ʁ i ʁ
^caverna$	k a v ɛ ʁ n ɐ
^sentir$	s ẽ tʃ i ʁ
^outono$	o t ɔ n u
^barraca$	b a ʁ a k ɐ
^evidente$	i v i d ẽ tʃ i
^poço$	p ɔ s u
^escuro$	i ʃ k u ɾ u
^lamber$	l ɐ̃ b e ʁ
^branco$	b ɾ ɐ̃ k u
^guerra$	ɡ ɛ ʁ ɐ
^semear$	s e m i a ʁ
^poste$	p ɔ ʃ tʃ i
^pé$	p ɛ
^deixar_cair$	d ei ʃ a ʁ + k a i ʁ
^levar_debaixo_do_braço$	l e v a ʁ + d e b ai ʃ u + d u + b ɾ a s u
^fogo$	f ɔ ɡ u
^embotado$	ẽ b o t a d u
^sábio$	s a b j u
^alfaiate$	au f ai a tʃ i
^fechar$	f e ʃ a ʁ
^lei$	l ei
^poderoso$	p o d e ɾ ɔ z u
^coisa$	k oi z ɐ
^esperança$	i ʃ p e ɾ ɐ̃ s ɐ
^gripe$	ɡ ɾ i p i
^xícara$	ʃ i k a ɾ ɐ
^ontem$	õ t ẽĩ
^tubarão$	t u b a ɾ ɐ̃ũ
^recife$	ʁ e s i f i
^tossir$	t o s i ʁ
^colarinho$	k o l a ɾ i ɲ u
^floresta$	f l o ɾ ɛ ʃ t ɐ
^pistola$	p i ʃ t ɔ l ɐ
^construir$	k õ ʃ t ɾ ui ʁ
^em_breve$	ẽĩ + b ɾ ɛ v i
^subir$	s u b i ʁ
^pena$	p ɛ n ɐ
^irmã$	i ʁ m ɐ̃
^caracol$	k a ɾ a k ɔu
^descascar$	d e ʃ k a ʃ k a ʁ
^quarto$	k w a ʁ t u
^estender$	i ʃ t ẽ d e ʁ
^raiva$	ʁ ai v ɐ
^pires$	p i ɾ e ʃ
^árvore$	a ʁ v u ɾ i
^durar$	d u ɾ a ʁ
^rainha$	ʁ ai ɲ ɐ
^laguna$	l a ɡ u n ɐ
^bezerro$	b e z ɛ ʁ u
^maré_alta$	m a ɾ ɛ + au t ɐ
^rasgar$	ʁ a ʒ ɡ a ʁ
^urinar$	u ɾ i n a ʁ
^sol$	s ɔu
^livro$	l i v ɾ u
^cará$	k a ɾ a
^tambor$	t ɐ̃ b ɔ ʁ
^torto$	t ɔ ʁ t u
^comprar$	k õ p ɾ a ʁ
^enrugado$	ẽ ʁ u ɡ a d u
^palavra$	p a l a v ɾ ɐ
^multa$	m uu t ɐ
^botão$	b o t ɐ̃ũ
^ave$	a v i
^escudo$	i ʃ k u d u
^ciúme$	s i u m i
^hidromel$	i d ɾ o m ɛu
^falcão$	f au k ɐ̃ũ
^febre$	f ɛ b ɾ i
^lama$	l ɐ m ɐ
^contar$	k õ t a ʁ
^admitir$	a dʒ i m i tʃ i ʁ
^concha$	k õ ʃ ɐ
^pregar$	p ɾ e ɡ a ʁ
^roupa$	ʁ o p ɐ
^louco$	l o k u
^barata$	b a ɾ a t ɐ
^cabo$	k a b u
^trocar$	t ɾ o k a ʁ
^úmido$	u m i d u
^topo$	t ɔ p u
^sobrinho$	s o b ɾ i ɲ u
^nenê$	n e n e
^montanha$	m õ t ɐ ɲ ɐ
^cinco$	s ĩ k u
^gambá$	ɡ ɐ̃ b a
^conduzir$	k õ d u z i ʁ
^reto$	ʁ ɛ t u
^pegar_em_armadilha$	p e ɡ a ʁ + ẽĩ + a ʁ m a dʒ i ʎ ɐ
^ancinho$	ɐ̃ s i ɲ u
^pais$	p ai ʃ
^cinzas$	s ĩ z a ʃ
^beliscar$	b e l i ʃ k a ʁ
^incêndio_culposo$	ĩ s ẽ d j u + k uu p ɔ z u
^oeste$	o e ʃ tʃ i
^palma_de_mão$	p au m ɐ + dʒ i + m ɐ̃ũ
^grão$	ɡ ɾ ɐ̃ũ
^maxila$	m a k s i l ɐ
^começar$	k o m e s a ʁ
^completar$	k õ p l e t a ʁ
^nomear$	n o m i a ʁ
^lembrar-se$	l ẽ b ɾ a ʁ s i
^quando$	k w ɐ̃ d u
^ir$	i ʁ
^perder$	p e ʁ d e ʁ
^planície$	p l ɐ n i s i i
^feminino$	f e m i n i n u
^cume$	k u m i
^lago$	l a ɡ u
^praia$	p ɾ ai ɐ
^raspar$	ʁ a ʃ p a ʁ
^vassoura$	v a s o ɾ ɐ
^mostrar$	m o ʃ t ɾ a ʁ
^cálido$	k a l i d u
^pestanejar$	p e ʃ t ɐ n e ʒ a ʁ
^ouvir$	o v i ʁ
^viga$	v i ɡ ɐ
^vidro$	v i d ɾ u
^desejo$	d e z e ʒ u
^parar$	p a ɾ a ʁ
^canoa$	k ɐ n o ɐ
^lareira$	l a ɾ ei ɾ ɐ
^soprar$	s o p ɾ a ʁ
^tudo$	t u d u
^contas$	k õ t a ʃ
^jactar-se$	ʒ a k t a ʁ s i
^dedo$	d ɛ d u
^fuzilar$	f u z i l a ʁ
^errado$	i ʁ a d u
^chegar$	ʃ e ɡ a ʁ
^narina$	n a ɾ i n ɐ
^menina$	m e n i n ɐ
^raso$	ʁ a z u
^longe$	l õ ʒ i
^enfeite$	ẽ f ei tʃ i
^levar_no_ombro$	l e v a ʁ + n u + õ b ɾ u
^gancho$	ɡ ɐ̃ ʃ u
^praiamar$	p ɾ ai ɐ m a ʁ
^tecido$	t e s i d u
^ratinho$	ʁ a tʃ i ɲ u
^estátua$	i ʃ t a t u ɐ
^planta$	p l ɐ̃ t ɐ
^pantanal$	p ɐ̃ t ɐ n au
^vespa$	v ɛ ʃ p ɐ
^casa$	k a z ɐ
^próximo$	p ɾ ɔ s i m u
^pêlo_púbico$	p e l u + p u b i k u
^ovo$	ɔ v u
^lavrador$	l a v ɾ a d o ʁ
^jantar$	ʒ ɐ̃ t a ʁ
^nu$	n u
^idéia$	i d ɛi ɐ
^separar$	s e p a ɾ a ʁ
^frango$	f ɾ ɐ̃ ɡ u
^prata$	p ɾ a t ɐ
^salgado$	s au ɡ a d u
^osso$	ɔ s u
^segundo$	s e ɡ ũ d u
^fígado$	f i ɡ a d u
^maré_vazia$	m a ɾ ɛ + v a z i ɐ
^impedir$	ĩ p e dʒ i ʁ
^oito$	oi t u
^cesto$	s ɛ ʃ t u
^navio$	n a v j u
^vala$	v a l ɐ
^asa$	a z ɐ
^úbere$	u b e ɾ i
^cílio$	s i l j u
^assobiar$	a s o b i a ʁ
^chato$	ʃ a t u
^bicho$	b i ʃ u
^romper$	ʁ õ p e ʁ
^pesado$	p e z a d u
^palmeira$	p au m ei ɾ ɐ
^noite$	n oi tʃ i
^vara$	v a ɾ ɐ
^frente$	f ɾ ẽ tʃ i
^campo$	k ɐ̃ p u
^loja$	l ɔ ʒ ɐ
^garota$	ɡ a ɾ ɔ t ɐ
^raízes_venenosas$	ʁ a i z e ʃ + v e n e n ɔ z a ʃ
^voar$	v o a ʁ
^neta$	n ɛ t ɐ
^filha$	f i ʎ ɐ
^toalha$	t o a ʎ ɐ
^partir$	p a ʁ tʃ i ʁ
^perna$	p ɛ ʁ n ɐ
^brincar$	b ɾ ĩ k a ʁ
^ramo$	ʁ ɐ m u
^fender$	f ẽ d e ʁ
^espinha_dorsal$	i ʃ p i ɲ ɐ + d o ʁ s au
^aveia$	a v ei ɐ
^metade$	m e t a dʒ i
^barrote$	b a ʁ ɔ tʃ i
^parecido$	p a ɾ e s i d u
^regressar$	ʁ e ɡ ɾ e s a ʁ
^apunhalar$	a p u ɲ a l a ʁ
^óleo$	ɔ l i u
^mal_cheiroso$	m au + ʃ ei ɾ ɔ z u
^cadáver$	k a d a v e ʁ
^ventilador$	v ẽ tʃ i l a d o ʁ
^pano$	p ɐ n u
^delgado$	d ɛu ɡ a d u
^sal$	s au
^tiritar$	tʃ i ɾ i t a ʁ
^remo$	ʁ ɛ m u
^feiticeiro$	f ei tʃ i s ei ɾ u
^amigo$	ɐ m i ɡ u
^ar$	a ʁ
^furúnculo$	f u ɾ ũ k u l u
^orvalho$	o ʁ v a ʎ u
^dente$	d ẽ tʃ i
^deitar-se$	d ei t a ʁ s i
^trovão$	t ɾ o v ɐ̃ũ
^sorrir$	s o ʁ i ʁ
^como$	k ɔ m u
^causa$	k au z ɐ
^adorno$	a d ɔ ʁ n u
^costas$	k ɔ ʃ t a ʃ
^tocar$	t o k a ʁ
^abutre$	a b u t ɾ i
^frio$	f ɾ j ɔ
^ilha$	i ʎ ɐ
^pirilampo$	p i ɾ i l ɐ̃ p u
^guelra$	ɡ ɛu ʁ ɐ
^pedra$	p ɛ d ɾ ɐ
^fronteira$	f ɾ õ t ei ɾ ɐ
^tijolo$	tʃ i ʒ ɔ l u
^dormir$	d o ʁ m i ʁ
^permitir$	p e ʁ m i tʃ i ʁ
^dois$	d oi ʃ
^escorpião$	i ʃ k o ʁ p i ɐ̃ũ
^meio$	m ei u
^corpo$	k ɔ ʁ p u
^trança$	t ɾ ɐ̃ s ɐ
^batata$	b a t a t ɐ
^sapato$	s a p a t u
^mau$	m au
^despido$	d e ʃ p i d u
^preamar$	p ɾ i ɐ m a ʁ
^rezar$	ʁ e z a ʁ
^buscar$	b u ʃ k a ʁ
^prole$	p ɾ ɔ l i
^saco$	s a k u
^argamassa$	a ʁ ɡ ɐ m a s ɐ
^sulco$	s uu k u
^oferenda$	o f e ɾ ẽ d ɐ
^solo$	s ɔ l u
^redemoinho$	ʁ e d e m oi ɲ u
^estilingue$	i ʃ tʃ i l ĩ ɡ i
^gabar-se$	ɡ a b a ʁ s i
^calma$	k au m ɐ
^maré_baixa$	m a ɾ ɛ + b ai ʃ ɐ
^morrer$	m o ʁ e ʁ
^costela$	k o ʃ t ɛ l ɐ
^ir-se_embora$	i ʁ s i + ẽ b ɔ ɾ ɐ
^abaixo$	a b ai ʃ u
^rolar$	ʁ o l a ʁ
^lodo$	l ɔ d u
^remédio$	ʁ e m ɛ d j u
^incendiar$	ĩ s ẽ dʒ i a ʁ
^azedo$	a z ɛ d u
^caspa$	k a ʃ p ɐ
^costa$	k ɔ ʃ t ɐ
^chifre$	ʃ i f ɾ i
^ficar$	f i k a ʁ
^aprender$	a p ɾ ẽ d e ʁ
^varrão$	v a ʁ ɐ̃ũ
^brilhar$	b ɾ i ʎ a ʁ
^caneta$	k ɐ n ɛ t ɐ
^punição$	p u n i s ɐ̃ũ
^saber$	s a b e ʁ
^caminho$	k ɐ m i ɲ u
^podre$	p ɔ d ɾ i
^irmão$	i ʁ m ɐ̃ũ
^ceifar$	s ei f a ʁ
^sogra$	s ɔ ɡ ɾ ɐ
^ferida$	f e ɾ i d ɐ
^carroça$	k a ʁ ɔ s ɐ
^bochecha$	b o ʃ e ʃ ɐ
^dividir$	dʒ i v i dʒ i ʁ
^escorrer$	i ʃ k o ʁ e ʁ
^senhor$	s e ɲ ɔ ʁ
^fósforo$	f ɔ ʃ f u ɾ u
^égua$	ɛ ɡ w ɐ
^cuidar_de$	k ui d a ʁ + dʒ i
^apressar$	a p ɾ e s a ʁ
^quinta-feira$	k ĩ t a f ei ɾ ɐ
^raia$	ʁ ai ɐ
^roda$	ʁ ɔ d ɐ
^acender$	a s ẽ d e ʁ
^chaleira$	ʃ a l ei ɾ ɐ
^preservar$	p ɾ e z e ʁ v a ʁ
^dono$	d ɔ n u
^peúga$	p e u ɡ ɐ
^chaga$	ʃ a ɡ ɐ
^cair$	k a i ʁ
^brilhante$	b ɾ i ʎ ɐ̃ tʃ i
^cachoeira$	k a ʃ o ei ɾ ɐ
^fora$	f ɔ ɾ ɐ
^barro$	b a ʁ u
^limpo$	l ĩ p u
^quinze$	k ĩ z i
^boa_sorte$	b o ɐ + s ɔ ʁ tʃ i
^chouriço$	ʃ o ɾ i s u
^bastão$	b a ʃ t ɐ̃ũ
^nascente$	n a ʃ s ẽ tʃ i
^amanhã$	ɐ m ɐ ɲ ɐ̃
^acreditar$	a k ɾ e dʒ i t a ʁ
^masculino$	m a ʃ k u l i n u
^bosque$	b ɔ s k i
^lobo$	l ɔ b u
^corante$	k o ɾ ɐ̃ tʃ i
^curto$	k u ʁ t u
^cordeiro$	k o ʁ d ei ɾ u
^rico$	ʁ i k u
^dinheiro$	dʒ i ɲ ei ɾ u
^divórcio$	dʒ i v ɔ ʁ s j u
^orar$	o ɾ a ʁ
^coruja$	k o ɾ u ʒ ɐ
^sentenciar$	s ẽ t ẽ s i a ʁ
^carne$	k a ʁ n i
^túmulo$	t u m u l u
^ordenhar$	o ʁ d e ɲ a ʁ
^elevado$	i l e v a d u
^maluco$	m a l u k u
^capa$	k a p ɐ
^travesseiro$	t ɾ a v e s ei ɾ u
^não_acertar$	n ɐ̃ũ + a s e ʁ t a ʁ
^tribo$	t ɾ i b u
^cheio$	ʃ ei u
^precipício$	p ɾ e s i p i s j u
^formiga$	f o ʁ m i ɡ ɐ
^baía$	b a i ɐ
^atar$	a t a ʁ
^miolos$	m j ɔ l u ʃ
^bastante$	b a ʃ t ɐ̃ tʃ i
^janela$	ʒ ɐ n ɛ l ɐ
^mocho$	m ɔ ʃ u
^orelha$	o ɾ e ʎ ɐ
^compaixão$	k õ p ai ʃ ɐ̃ũ
^taxa$	t a ʃ ɐ
^alugar$	a l u ɡ a ʁ
^ferro$	f ɛ ʁ u
^lugar$	l u ɡ a ʁ
^córrego$	k ɔ ʁ e ɡ u
^magia$	m a ʒ i ɐ
^quantos$	k w ɐ̃ t u ʃ
^resfriado$	ʁ e ʃ f ɾ i a d u
^recusar$	ʁ e k u z a ʁ
^café_da_manhã$	k a f ɛ + d ɐ + m ɐ ɲ ɐ̃
^ousar$	o z a ʁ
^oleiro$	o l ei ɾ u
^brânquia$	b ɾ ɐ̃ k i ɐ
^umbigo$	ũ b i ɡ u
^machado$	m a ʃ a d u
^rastejar$	ʁ a ʃ t e ʒ a ʁ
^espaço$	i ʃ p a s u
^pátria$	p a t ɾ i ɐ
^idade$	i d a dʒ i
^hoje$	ɔ ʒ i
^presságio$	p ɾ e s a ʒ j u
^torre$	t ɔ ʁ i
^barba$	b a ʁ b ɐ
^assassinar$	a s a s i n a ʁ
^cera$	s ɛ ɾ ɐ
^procurar$	p ɾ o k u ɾ a ʁ
^bruxa$	b ɾ u ʃ ɐ
^ele$	e l i
^prometer$	p ɾ o m e t e ʁ
^cão$	k ɐ̃ũ
^balsa$	b au s ɐ
^sexta-feira$	s e ʃ t a f ei ɾ ɐ
^ela$	ɛ l ɐ
^esfregar$	i ʃ f ɾ e ɡ a ʁ
^tigela$	tʃ i ʒ ɛ l ɐ
^pequeno$	p e k e n u
^cobra$	k ɔ b ɾ ɐ
^coração$	k o ɾ a s ɐ̃ũ
^ajoelhar$	a ʒ o e ʎ a ʁ
^pôrto$	p o ʁ t u
^isca$	i ʃ k ɐ
^mendigo$	m ẽ dʒ i ɡ u
^nariz$	n a ɾ i ʃ
^bolota$	b o l ɔ t ɐ
^casamento$	k a z ɐ m ẽ t u
^vereda$	v e ɾ ɛ d ɐ
^salvar$	s au v a ʁ
^réu$	ʁ ɛu
^juramento$	ʒ u ɾ ɐ m ẽ t u
^fritar$	f ɾ i t a ʁ
^cesta$	s ɛ ʃ t ɐ
^tinta$	tʃ ĩ t ɐ
^sapateiro$	s a p a t ei ɾ u
^porque$	p u ʁ k i
^preocupação$	p ɾ i o k u p a s ɐ̃ũ
^embriagado$	ẽ b ɾ i a ɡ a d u
^responder$	ʁ e ʃ p õ d e ʁ
^quem$	k ẽĩ
^grande$	ɡ ɾ ɐ̃ dʒ i
^cerume$	s e ɾ u m i
^médico$	m ɛ dʒ i k u
^escova$	i ʃ k ɔ v ɐ
^vocês$	v o s e ʃ
^santo$	s ɐ̃ t u
^ceia$	s ei ɐ
^saia_de_palha$	s ai ɐ + dʒ i + p a ʎ ɐ
^bater$	b a t e ʁ
^escutar$	i ʃ k u t a ʁ
^sombra$	s õ b ɾ ɐ
^bem$	b ẽĩ
^preguiçoso$	p ɾ e ɡ j s ɔ z u
^empola$	ẽ p ɔ l ɐ
^papagaio$	p a p a ɡ ai u
^atear$	a tʃ i a ʁ
^aldeia$	au d ei ɐ
^chefe$	ʃ ɛ f i
^enteado$	ẽ tʃ i a d u
^mel$	m ɛu
^meio_dia$	m ei u + dʒ i ɐ
^segredo$	s e ɡ ɾ ɛ d u
^relógio$	ʁ e l ɔ ʒ j u
^aberto$	a b ɛ ʁ t u
^pêlo$	p e l u
^armadilha_de_peixa$	a ʁ m a dʒ i ʎ ɐ + dʒ i + p ei ʃ ɐ
^descendentes$	d e ʃ s ẽ d ẽ t e ʃ
^colher$	k o ʎ e ʁ
^seda$	s ɛ d ɐ
^ancestrais$	ɐ̃ s e ʃ t ɾ ai ʃ
^órfã$	ɔ ʁ f ɐ̃
^pintar$	p ĩ t a ʁ
^grosso$	ɡ ɾ ɔ s u
^varrer$	v a ʁ e ʁ
^vaca$	v a k ɐ
^nunca$	n ũ k ɐ
^vinha$	v i ɲ ɐ
^veado$	v i a d u
^papel$	p a p ɛu
^tartaruga$	t a ʁ t a ɾ u ɡ ɐ
^anteontem$	ɐ̃ tʃ i õ t ẽĩ
^hábil$	a b iu
^violação$	v j o l a s ɐ̃ũ
^grama$	ɡ ɾ ɐ m ɐ
^retirar-se$	ʁ e tʃ i ɾ a ʁ s i
^emboscada$	ẽ b o ʃ k a d ɐ
^legumes$	l e ɡ u m e ʃ
^largar$	l a ʁ ɡ a ʁ
^seguir$	s e ɡ i ʁ
^salário$	s a l a ɾ j u
^desatar$	d e z a t a ʁ
^espalhar$	i ʃ p a ʎ a ʁ
^genro$	ʒ ẽ ʁ u
^emprenhar$	ẽ p ɾ e ɲ a ʁ
^margem$	m a ʁ ʒ ẽĩ
^cauda$	k au d ɐ
^verter$	v e ʁ t e ʁ
^maneira$	m ɐ n ei ɾ ɐ
^elogiar$	i l o ʒ i a ʁ
^sovaco$	s o v a k u
^amaldiçoar$	ɐ m au dʒ i s o a ʁ
^nora$	n ɔ ɾ ɐ
^garanhão$	ɡ a ɾ ɐ ɲ ɐ̃ũ
^áspero$	a ʃ p e ɾ u
^trombeta$	t ɾ õ b ɛ t ɐ
^parte$	p a ʁ tʃ i
^moinho$	m oi ɲ u
^lóbulo$	l ɔ b u l u
^juiz$	ʒ u i ʃ
^derrota$	d e ʁ ɔ t ɐ
^acha$	a ʃ ɐ
^amoldar$	ɐ m ɔu d a ʁ
^cada$	k a d ɐ
^casado$	k a z a d u
^vender$	v ẽ d e ʁ
^chão$	ʃ ɐ̃ũ
^último$	uu tʃ i m u
^pagar$	p a ɡ a ʁ
^galo$	ɡ a l u
^patrão$	p a t ɾ ɐ̃ũ
^eira$	ei ɾ ɐ
^macaco$	m a k a k u
^sagrado$	s a ɡ ɾ a d u
^conjeturar$	k õ ʒ e t u ɾ a ʁ
^medo$	m e d u
^companheiro$	k õ p ɐ ɲ ei ɾ u
^mesa$	m ɛ z ɐ
^canga$	k ɐ̃ ɡ ɐ
^cozinhado$	k o z i ɲ a d u
^cobiçoso$	k o b i s ɔ z u
^tomar_banho$	t o m a ʁ + b ɐ ɲ u
^colheita$	k o ʎ ei t ɐ
^preço$	p ɾ ɛ s u
^escravo$	i ʃ k ɾ a v u
^fluir$	f l ui ʁ
^porco$	p ɔ ʁ k u
^bebê$	b e b e
^chamar-se$	ʃ ɐ m a ʁ s i
^tecer$	t e s e ʁ
^deixar$	d ei ʃ a ʁ
^curar$	k u ɾ a ʁ
^leste$	l ɛ ʃ tʃ i
^gritar$	ɡ ɾ i t a ʁ
^repreender$	ʁ e p ɾ e ẽ d e ʁ
^prostituta$	p ɾ o ʃ tʃ i t u t ɐ
^tatuagem$	t a t u a ʒ ẽĩ
^cortar$	k o ʁ t a ʁ
^bater_com_o_punho$	b a t e ʁ + k õ + u + p u ɲ u
^garfo$	ɡ a ʁ f u
^direita$	dʒ i ɾ ei t ɐ
^corda$	k ɔ ʁ d ɐ
^cento$	s ẽ t u
^obter$	o b t e ʁ
^pulso$	p uu s u
^escapar$	i ʃ k a p a ʁ
^sentinela$	s ẽ tʃ i n ɛ l ɐ
^capin$	k a p ĩ
^caminhar$	k ɐ m i ɲ a ʁ
^queijo$	k ei ʒ u
^potro$	p ɔ t ɾ u
^adobe$	a d ɔ b i
^família$	f ɐ m i l i ɐ
^verduras$	v e ʁ d u ɾ a ʃ
^palha$	p a ʎ ɐ
^render-se$	ʁ ẽ d ɛ ʁ s i
^mastigar$	m a ʃ tʃ i ɡ a ʁ
^arco$	a ʁ k u
^semente$	s e m ẽ tʃ i
^segar$	s e ɡ a ʁ
^sobrancelha$	s o b ɾ ɐ̃ s e ʎ ɐ
^restos$	ʁ ɛ ʃ t u ʃ
^chapéu$	ʃ a p ɛu
^ninho$	n i ɲ u
^afogado$	a f o ɡ a d u
^nuca$	n u k ɐ
^enviar$	ẽ v i a ʁ
^soalho$	s o a ʎ u
^erva$	ɛ ʁ v ɐ
^bebida_fermentada$	b e b i d ɐ + f e ʁ m ẽ t a d ɐ
^por_quê$	p u ʁ + k e
^discursar$	dʒ i ʃ k u ʁ s a ʁ
^estorvar$	i ʃ t o ʁ v a ʁ
^escavar$	i ʃ k a v a ʁ
^onde$	õ dʒ i
^cocheira$	k o ʃ ei ɾ ɐ
^irmão_mais_velho$	i ʁ m ɐ̃ũ + m ai ʃ + v ɛ ʎ u
^raposa$	ʁ a p ɔ z ɐ
^luta$	l u t ɐ
^gruta$	ɡ ɾ u t ɐ
^sul$	s uu
^cicatriz$	s i k a t ɾ i ʃ
^cativo$	k a tʃ i v u
^arco-íris$	a ʁ k o i ɾ i ʃ
^suficiente$	s u f i s i ẽ tʃ i
^despejar$	d e ʃ p e ʒ a ʁ
^pimenta$	p i m ẽ t ɐ
^vale$	v a l i
^afiado$	a f i a d u
^neve$	n ɛ v i
^trave$	t ɾ a v i
^mundo$	m ũ d u
^antes$	ɐ̃ t e ʃ
^ligeiro$	l i ʒ ei ɾ u
^correr$	k o ʁ e ʁ
^milho$	m i ʎ u
^mexer$	m e ʃ e ʁ
^têmpora$	t ẽ p u ɾ ɐ
^bode$	b ɔ dʒ i
^tornozelo$	t o ʁ n o z ɛ l u
^vida$	v i d ɐ
^ter$	t e ʁ
^culpado$	k uu p a d u
^manto$	m ɐ̃ t u
^baleia$	b a l ei ɐ
^cabana$	k a b ɐ n ɐ
^quadril$	k w a d ɾ iu
^amarrar$	ɐ m a ʁ a ʁ
^qual$	k w au
^gelo$	ʒ ɛ l u
^cruz$	k ɾ u ʃ
^guiar$	ɡ j a ʁ
^ficar_em_silêncio$	f i k a ʁ + ẽĩ + s i l ẽ s j u
^negociante$	n e ɡ o s i ɐ̃ tʃ i
^mama$	m ɐ m ɐ
^depois$	d e p oi ʃ
^sogro$	s ɔ ɡ ɾ u
^vizinho$	v i z i ɲ u
^pobre$	p ɔ b ɾ i
^esticar$	i ʃ tʃ i k a ʁ
^depois_de_amanhã$	d e p oi ʒ + dʒ i + ɐ m ɐ ɲ ɐ̃
^cuspir$	k u ʃ p i ʁ
^vergonha$	v e ʁ ɡ ɔ ɲ ɐ
^arar$	a ɾ a ʁ
^poucos$	p o k u ʃ
^enterrar$	ẽ t e ʁ a ʁ
^uivar$	ui v a ʁ
^orgulhoso$	o ʁ ɡ u ʎ ɔ z u
^estrada$	i ʃ t ɾ a d ɐ
^perdoar$	p e ʁ d o a ʁ
^resvalar$	ʁ e ʒ v a l a ʁ
^papeira$	p a p ei ɾ ɐ
^aluno$	a l u n u
^farinha$	f a ɾ i ɲ ɐ
^convidado$	k õ v i d a d u
^urtiga$	u ʁ tʃ i ɡ ɐ
^chaminé$	ʃ ɐ m i n ɛ
^chorar$	ʃ o ɾ a ʁ
^tempestade$	t ẽ p e ʃ t a dʒ i
^debaixo$	d e b ai ʃ u
^dor$	d o ʁ
^pessoa$	p e s o ɐ
^papo$	p a p u
^bico$	b i k u
^mão_de_pilão$	m ɐ̃ũ + dʒ i + p i l ɐ̃ũ
^navalha_de_barba$	n a v a ʎ ɐ + dʒ i + b a ʁ b ɐ
^conspiração$	k õ ʃ p i ɾ a s ɐ̃ũ
^verde$	v ɛ ʁ dʒ i
^vermelho$	v e ʁ m e ʎ u
^lutar$	l u t a ʁ
^sepultura$	s e p uu t u ɾ ɐ
^ensinar$	ẽ s i n a ʁ
^baixo$	b ai ʃ u
^cachimbo$	k a ʃ ĩ b u
^veneno$	v e n ɛ n u
^ruidoso$	ʁ ui d ɔ z u
^círculo$	s i ʁ k u l u
^rapaz$	ʁ a p a ʃ
^fazendeiro$	f a z ẽ d ei ɾ u
^barbatana$	b a ʁ b a t ɐ n ɐ
^gemer$	ʒ e m e ʁ
^falhar$	f a ʎ a ʁ
^fosso$	f ɔ s u
^relatar$	ʁ e l a t a ʁ
^barco$	b a ʁ k u
^quieto$	k i ɛ t u
^joelho$	ʒ o e ʎ u
^infortúnio$	ĩ f o ʁ t u n j u
^alegre$	a l ɛ ɡ ɾ i
^esfera$	i ʃ f e ɾ ɐ
^costurar$	k o ʃ t u ɾ a ʁ
^coxear$	k o ʃ i a ʁ
^súdito$	s u dʒ i t u
^partido$	p a ʁ tʃ i d u
^peido$	p ei d u
^compreender$	k õ p ɾ e ẽ d e ʁ
^tio$	t j ɔ
^sobrinha$	s o b ɾ i ɲ ɐ
^de_imediato$	dʒ i + i m e dʒ i a t u
^vinho$	v i ɲ u
^céu$	s ɛu
^suar$	s u a ʁ
^obscuro$	o b ʃ k u ɾ u
^bravo$	b ɾ a v u
^escola$	i ʃ k ɔ l ɐ
^pôr$	p o ʁ
^ouro$	o ɾ u
^madeira$	m a d ei ɾ ɐ
^calvo$	k au v u
^pendurar$	p ẽ d u ɾ a ʁ
^içar$	i s a ʁ
^duas$	d u a ʃ
^sabão$	s a b ɐ̃ũ
^canhão$	k ɐ ɲ ɐ̃ũ
^mulo$	m u l u
^cadeira$	k a d ei ɾ ɐ
^ladrão$	l a d ɾ ɐ̃ũ
^aproximar$	a p ɾ o s i m a ʁ
^soldado$	s ɔu d a d u
^chutar$	ʃ u t a ʁ
^dançar$	d ɐ̃ s a ʁ
^sentar-se$	s ẽ t a ʁ s i
^confessar$	k õ f e s a ʁ
^matrimônio$	m a t ɾ i m o n j u
^semana$	s e m ɐ n ɐ
^terceiro$	t e ʁ s ei ɾ u
^faia$	f ai ɐ
^cordel$	k o ʁ d ɛu
^perjúrio$	p e ʁ ʒ u ɾ j u
^espinhaço$	i ʃ p i ɲ a s u
^cobrir$	k o b ɾ i ʁ
^soluço$	s o l u s u
^peixe$	p ei ʃ i
^riacho$	ʁ i a ʃ u
^agulha$	a ɡ u ʎ ɐ
^sujo$	s u ʒ u
^sufocar$	s u f o k a ʁ
^fiar$	f i a ʁ
^pinheiro$	p i ɲ ei ɾ u
^nascer$	n a ʃ s e ʁ
^domingo$	d o m ĩ ɡ u
^paz$	p a ʃ
^cobertor$	k o b e ʁ t o ʁ
^pegada$	p e ɡ a d ɐ
^tingir$	tʃ ĩ ʒ i ʁ
^pescador$	p e ʃ k a d o ʁ
^feio$	f ei u
^às_vezes$	a ʃ + v ɛ z e ʃ
^tear$	tʃ i a ʁ
^dobrar$	d o b ɾ a ʁ
^azeitona$	a z ei t o n ɐ
^tripas$	t ɾ i p a ʃ
^camelo$	k ɐ m ɛ l u
^estupro$	i ʃ t u p ɾ u
^alma$	au m ɐ
^corno$	k ɔ ʁ n u
^dívida$	dʒ i v i d ɐ
^bétula$	b ɛ t u l ɐ
^sugar$	s u ɡ a ʁ
^sopa$	s o p ɐ
^pássaro$	p a s a ɾ u
^arroz$	a ʁ ɔ ʃ
^lábio$	l a b j u
^caro$	k a ɾ u
^terreno$	t e ʁ e n u
^asno$	a ʒ n u
^algodão$	au ɡ o d ɐ̃ũ
^tempestuoso$	t ẽ p e ʃ t u ɔ z u
^centeio$	s ẽ t ei u
^garoto$	ɡ a ɾ ɔ t u
^pai$	p ai
^rápido$	ʁ a p i d u
^atacar$	a t a k a ʁ
^homem_livre$	ɔ m ẽĩ + l i v ɾ i
^proibir$	p ɾ oi b i ʁ
^muitos$	m ũ j t u ʃ
^águia$	a ɡ j ɐ
^saltar$	s au t a ʁ
^parecer$	p a ɾ e s e ʁ
^perante$	p e ɾ ɐ̃ tʃ i
^cabeça$	k a b ɛ s ɐ
^prateleira$	p ɾ a t e l ei ɾ ɐ
^olho$	ɔ ʎ u
^gaguejar$	ɡ a ɡ e ʒ a ʁ
^fronte$	f ɾ õ tʃ i
^de_novo$	dʒ i + n ɔ v u
^acusado$	a k u z a d u
^fuso$	f u z u
^fruta_cítrica$	f ɾ u t ɐ + s i t ɾ i k ɐ
^lenço$	l ẽ s u
^gordura$	ɡ o ʁ d u ɾ ɐ
^vazio$	v a z j u
^inocente$	i n o s ẽ tʃ i
^ganso$	ɡ ɐ̃ s u
^flutuar$	f l u t u a ʁ
^boina$	b oi n ɐ
^casaco$	k a z a k u
^abraçar$	a b ɾ a s a ʁ
^cinzel$	s ĩ z ɛu
^pedreiro$	p e d ɾ ei ɾ u
^feijão$	f ei ʒ ɐ̃ũ
^pênis$	p e n i ʃ
^camisa$	k ɐ m i z ɐ
^ou$	ou
^rocha$	ʁ ɔ ʃ ɐ
^ganhar$	ɡ ɐ ɲ a ʁ
^abóbora$	a b ɔ b u ɾ ɐ
^chávena$	ʃ a v e n ɐ
^que$	k i
^medir$	m e dʒ i ʁ
^muito$	m ũ j t u
^cem$	s ẽĩ
^estrela$	i ʃ t ɾ ɛ l ɐ
^comichão$	k o m i ʃ ɐ̃ũ
^cavalo$	k a v a l u
^fungar$	f ũ ɡ a ʁ
^sede$	s ɛ dʒ i
^carpinteiro$	k a ʁ p ĩ t ei ɾ u
^cavar$	k a v a ʁ
^eixo$	ei ʃ u
^jurar$	ʒ u ɾ a ʁ
^mãe$	m ɐ̃ĩ
^chupar$	ʃ u p a ʁ
^teia_de_aranha$	t ei ɐ + dʒ i + a ɾ ɐ ɲ ɐ
^cabelo$	k a b ɛ l u
^língua$	l ĩ ɡ w ɐ
^peneira$	p e n ei ɾ ɐ
^amiúde$	ɐ m i u dʒ i
^ácido$	a s i d u
^lã$	l ɐ̃
^leme$	l ɛ m i
^surdo$	s u ʁ d u
^estreito$	i ʃ t ɾ ei t u
^pó$	p ɔ
^ser_humano$	s e ʁ + u m ɐ n u
^armadura$	a ʁ m a d u ɾ ɐ
^cacique$	k a s i k i
^governante$	ɡ o v e ʁ n ɐ̃ tʃ i
^clavícula$	k l a v i k u l ɐ
^vela$	v ɛ l ɐ
^falar$	f a l a ʁ
^água$	a ɡ w ɐ
^três_vezes$	t ɾ e ʃ + v ɛ z e ʃ
^pescoço$	p e ʃ k ɔ s u
^curvar$	k u ʁ v a ʁ
^nós$	n ɔ ʃ
^tragar$	t ɾ a ɡ a ʁ
^doze$	d o z i
^zero$	z ɛ ɾ u
^apertar$	a p e ʁ t a ʁ
^padrasto$	p a d ɾ a ʃ t u
^costume$	k o ʃ t u m i
^barulhento$	b a ɾ u ʎ ẽ t u
^cansado$	k ɐ̃ s a d u
^hábito$	a b i t u
^mil$	m iu
^vagaroso$	v a ɡ a ɾ ɔ z u
^pedir$	p e dʒ i ʁ
^doença$	d o ẽ s ɐ
^montar$	m õ t a ʁ
^bigorna$	b i ɡ ɔ ʁ n ɐ
^tardinha$	t a ʁ dʒ i ɲ ɐ
^chumbo$	ʃ ũ b u
^pensar$	p ẽ s a ʁ
^quadrado$	k w a d ɾ a d u
^devolver$	d e v ɔu v e ʁ
^tia$	tʃ i ɐ
^relva$	ʁ ɛu v ɐ
^armadilha$	a ʁ m a dʒ i ʎ ɐ
^tocha$	t ɔ ʃ ɐ
^savannah$	s a v ɐ̃ n a
^cotovelo$	k o t o v ɛ l u
^cabra$	k a b ɾ ɐ
^burro$	b u ʁ u
^pente$	p ẽ tʃ i
^névoa$	n ɛ v u ɐ
^lua$	l u a
^viúvo$	v i u v u
^possuir$	p o s ui ʁ
^medicamento$	m e dʒ i k ɐ m ẽ t u
^mudar$	m u d a ʁ
^país$	p a i ʃ
^doente$	d o ẽ tʃ i
^esquina$	i s k i n ɐ
^beijar$	b ei ʒ a ʁ
^mulher$	m u ʎ e ʁ
^jugo$	ʒ u ɡ u
^débil$	d ɛ b iu
^esconder$	i ʃ k õ d e ʁ
^estudar$	i ʃ t u d a ʁ
^um$	ũ
^escuridão$	i ʃ k u ɾ i d ɐ̃ũ
^servo$	s ɛ ʁ v u
^a$	a
^anunciar$	ɐ n ũ s i a ʁ
^belo$	b ɛ l u
^compartilhar$	k õ p a ʁ tʃ i ʎ a ʁ
^testemunha$	t e ʃ t e m u ɲ ɐ
^sim$	s ĩ
^braço$	b ɾ a s u
^leve$	l ɛ v i
^dia$	dʒ i ɐ
^forcado$	f o ʁ k a d u
^caçar$	k a s a ʁ
